目標詞彙,音似形似,音異形似,音似形異,音異形異
屋子,剭子,握子,巫子,歪子
包子,孢子,袍子,褒子,追子
被子,褙子,彼子,背子,軒子
桃子,逃子,悲子,啕子,站子
柚子,釉子,柙子,祐子,胡子
