目標詞彙,音似形似,音異形似,音似形異,音異形異
褲子,庫子,神子,酷子,借子
帽子,冒子,賵子,貿子,周子
鍋子,堝子,銅子,郭子,取子
椅子,倚子,柯子,乙子,乘子
籃子,藍子,監子,蘭子,釋子
