目標圖片,音似形似,音異形似,音似形異,音異形異
兔子,菟子,免子,吐子,易子
珠子,株子,殊子,諸子,祝子
柿子,市子,沛子,士子,奇子
亭子,葶子,艼子,廷子,韋子
梳子,疏子,毓子,書子,訊子
笛子,迪子,苗子,敵子,商子
叉子,杈子,又子,差子,才子
丸子,芄子,九子,玩子,折子
杯子,盃子,柸子,卑子,和子
