目標詞彙,音同形似,音異形似,音同形異,音異形異
粽子,綜子,粹子,縱子,固子
罐子,灌子,歡子,冠子,喝子
櫃子,貴子,框子,跪子,書子
旗子,棋子,斯子,奇子,喜子
筷子,快子,筳子,塊子,照子
箱子,廂子,霜子,鄉子,乾子
蓮子,連子,運子,廉子,旁子
餃子,絞子,咬子,角子,唐子
梅子,莓子,悔子,玫子,佳子
鴨子,鴉子,鳩子,呀子,位子