目標圖片,音似形似,音異形似,音似形異,音異形異
小象,小像,小豫,小巷,小信
小球,小求,小救,小囚,小怒
小花,小化,小訛,小華,小命
小廟,小庙,小朝,小妙,小原
小床,小牀,小庚,小幢,小乖
小湖,小胡,小潮,小狐,小京
小羊,小洋,小羌,小陽,小卦
小山,小舢,小仙,小衫,小和
